111111111111
1..........1
1..........1
1..........1
1..111.111.1
1..........1
1..........1
111111111111